R 1000 1000

WE ./textures/wwall_w.xpm
NO ./textures/wwall_n.xpm

SO ./textures/wwall_s.xpm


EA ./textures/wwall_e.xpm
C 111,111,111
S ./textures/pillar.xpm
F 255,204,0



1111111111111111111111111
1010000000110000000000001
1011000001110000002000001
1001000000000000000000001
1111111110110000011100001
1000000000110000011101111
1111011111111101110000001
1111011111111101110101001
1100S00011010101110000001
1000200000000000110000001
1000000000000000110101001
1111111111111111111111111

