                                    R                                                                                                                                                                                                                                                                                                                                                                                                             1000                                                                                                                                                                                                                                                                                                                                                                                                 1000                                                                                                                                                                                                                                                                                                                                                                                                

                                    WE                          ./textures/wwall_w.xpm
                                       NO         ./textures/wwall_n.xpm

                           SO                            ./textures/wwall_s.xpm


      EA                             ./textures/wwall_e.xpm
                                                                              C    0,0,0
                                       S                             ./textures/pillar.xpm
                                       F 2                          ,              255           ,                            1



1111111111111111111111111
1010000000110000000000001
1011000001110000002000001
1001000000000000000000001
1111111110110000011100001
1000000000110000011101111
1111011111111101110000001
1111011111111101110101001
1100N00011010101110000001
1000200000000000110000001
1000000000000000110101001
1111111111111111111111111

